#########
#   ##  #
######  #
# # # $ #
##      #
#       #
# #   @ #
# # .   #
#########
