##########
#     $. #
#   # # @#
##       #
#   #    #
# #  .   #
# #  $   #
# #      #
#        #
##########
