##########
#        #
# $      #
#    #   #
#  # @  ##
##    #  #
#       .#
#  # #   #
#    #  ##
##########
