#########
#.     @#
# ### # #
# ###   #
#  ##   #
#  # #$ #
#    #  #
#       #
#########
