#########
# #     #
# #     #
#.##   @#
#  #  $ #
#      ##
# #     #
#       #
#########
