##########
# #      #
#  #     #
##     $ #
# .      #
##     # #
# #   #  #
#    #   #
#  . @$ ##
##########
