##########
#        #
#        #
## ##$#  #
#      # #
#    .   #
#     @  #
#  #   # #
#       ##
##########
