#########
# # # # #
# #     #
#       #
#.@   ###
#   $ ###
#$      #
#.      #
#########
