#########
#  #  . #
#  #  ###
#   $ ###
#       #
#       #
#   #  @#
#  ###  #
#########
