##########
#  #     #
#   $#   #
# #      #
#  @ .   #
##   # ###
#        #
#        #
#  #   ###
##########
