##########
#        #
#   #   $#
##      @#
#        #
##      .#
#        #
#   ##   #
#      # #
##########
