#########
# #     #
#       #
##      #
### #   #
#  @#   #
#   $.  #
#   ##  #
#########
