##########
#  #     #
#   $    #
#   ###  #
#        #
#        #
###    # #
#        #
#    @ . #
##########
