#########
##      #
####  # #
#  # ## #
# .   # #
###  $  #
##@     #
#       #
#########
