##########
#       ##
#        #
#  #     #
#   ##   #
#   $   ##
##      ##
#  #.   @#
#        #
##########
