#########
#    @  #
#  *   ##
# ## $  #
# #  #. #
# ##    #
#       #
#       #
#########
