##########
#        #
#   ##   #
#      ###
#        #
#   #    #
#  #   $ #
## #   # #
#   .@   #
##########
