#########
##      #
#  #    #
# $ $   #
#  #@   #
# .#    #
## #### #
##.     #
#########
