#########
# ##   .#
####    #
#   @$  #
#    #  #
#  #    #
## ###  #
#    #  #
#########
