##########
#   # #  #
#        #
#    ## .#
#  ##    #
#    #   #
#        #
#    $  ##
# #  @  ##
##########
