#########
# #     #
#####   #
# . #@  #
#    $  #
#     # #
#       #
#       #
#########
