##########
#        #
# #  .   #
#       ##
#        #
#   $    #
#  #     #
##     # #
#   # @  #
##########
