#########
#####   #
### #   #
# $     #
#       #
#.     ##
###     #
###    @#
#########
