##########
##  #    #
#    # $ #
# .   #  #
#       ##
#        #
#  #     #
#   #$ @ #
#  ##  #.#
##########
