##########
#    .   #
##   #   #
#      $ #
# ##     #
#      # #
#      # #
#       @#
# ##     #
##########
