#########
#       #
#  @   ##
#  # $  #
# ##    #
# *#    #
#  ## .##
# #    ##
#########
