##########
# #    # #
#.       #
#        #
#        #
#       ##
## @     #
##     $ #
# #      #
##########
