#########
#  #    #
#  ##$  #
####@   #
# # .   #
# #     #
#     ###
##      #
#########
