#########
# . #   #
#  ###  #
#   $   #
#@      #
####    #
#       #
#     # #
#########
