##########
#  #   @ #
# #      #
#  #     #
# $.#    #
# #    $ #
#  .     #
#        #
#    #   #
##########
