##########
#       .#
# #  #   #
#     @  #
#   # #$ #
#. #    ##
#        #
#  $     #
#       ##
##########
