#########
### @   #
# #     #
#  $  . #
# ####  #
#    #  #
#       #
#    ####
#########
