##########
## #     #
#  ##   .#
# #  #   #
#      # #
##       #
# #      #
#      $ #
#@    #  #
##########
