#########
#   .#  #
# ## #  #
# ##$   #
####   ##
# # @   #
#       #
#       #
#########
