##########
#   # #  #
# #  #   #
#   @    #
## $     #
#   *  . #
# #      #
#  #     #
#  #    ##
##########
