#########
#   .   #
##$## @ #
## #.   #
#       #
##  $   #
#   #   #
#      ##
#########
