#########
# ##    #
#    # ##
##   ####
#  $ @###
#      ##
#    .# #
#       #
#########
