##########
##    #  #
#     .  #
##       #
# #  # ###
#   #    #
#    @   #
##    $  #
#    #   #
##########
