#########
#  .  # #
#       #
#       #
#  #  ###
#     # #
##  $ ###
#    @  #
#########
