##########
# # #    #
#     #  #
#@   $   #
# #  ##  #
#      . #
#        #
##      ##
#        #
##########
