###########
#   ##  $.#
#       # #
#   $   . #
#       # #
## $####  #
#   #     #
#   #     #
# .       #
#@   #    #
###########
