##########
#     ## #
#$### #  #
# $   ## #
#.  #    #
#    $   #
#  # #   #
#  ###  ##
# . .@   #
##########
