##########
#  ..##  #
#$   ##  #
#    #   #
# $ @##  #
#.     $ #
#   ##   #
# $  # #.#
#    #   #
##########
