###########
# @  #    #
#      .  #
#   #     #
#         #
#         #
#       $ #
##   #    #
##      # #
##       ##
###########
