###########
#         #
#.  @ #   #
#    #    #
# # #  $ ##
# $    #  #
#        ##
#  .    # #
#   $ #   #
#  # # .  #
###########
