##########
#   ###  #
#  $ ### #
# .      #
#   $   .#
### $  ###
###  . ###
#  $##@  #
#  .     #
##########
