###########
#   ##  # #
###      *#
# @ # #   #
#    $    #
#    $  . #
#  #  .   #
#         #
##        #
#  #     ##
###########
