##########
#       .#
#    $  ##
# # $ ####
# # .  # #
# # #.$# #
#        #
#    ### #
#   @    #
##########
