###########
# @       #
# $     # #
#  .   #  #
#  # $   .#
#  ##     #
#      ## #
# $    #  #
#      .  #
#    #   ##
###########
