##########
#.     $ #
#   $    #
# .      #
# .#@ ## #
# .#   ###
# ###  $ #
## ## $  #
#        #
##########
