##########
##       #
# $     $#
#        #
# $###   #
#  ## .  #
#  #   @ #
#. ##  #.#
#  $.    #
##########
