###########
# #       #
#  $   #  #
##       ##
#  #  #   #
# # .     #
#         #
# #      ##
#  #      #
#@        #
###########
