##########
#.       #
#  $.    #
#.  @  ###
#####  ###
#   #    #
# $#     #
#     $  #
#  * #   #
##########
