###########
###    .  #
# #       #
## $##    #
#.  $    ##
#  $  @   #
#. #      #
#  #  #   #
#         #
#         #
###########
