##########
#   ..#  #
# $ . ####
#.   #  ##
#  $ # $ #
# $ @    #
#      ###
#      ###
#        #
##########
