###########
#   ###   #
#  # # #  #
#.# #  #  #
#         #
#         #
# ##$     #
##        #
#      #  #
#        @#
###########
