##########
#  . .$  #
# @      #
#  .  #  #
#  # $## #
# ###    #
#        #
#   $    #
#   ######
##########
