###########
# #    #  #
#         #
#   #    ##
#  #      #
# #       #
##     #  #
#  #@     #
#  #   $  #
#   .   # #
###########
