##########
# $ @.#  #
#    #   #
#  $### ##
#   .#   #
#        #
## ##$ $ #
##  # ##.#
#     # .#
##########
