###########
#       # #
# #    #  #
#         #
#     #   #
#  #### # #
#  $      #
#.#   # # #
##    @   #
#         #
###########
