##########
#  #.    #
#  $.    #
#$ .# #  #
# # ###  #
#       ##
#.  $  ###
#  @ $  ##
#        #
##########
