###########
#         #
#        ##
#   ##   .#
#       # #
#   $     #
#      ## #
#     ##  #
#     ##  #
# # @     #
###########
