###########
###    ## #
# $     # #
#    #   .#
#         #
# @       #
#       $ #
#   ##    #
#.   #    #
#      #  #
###########
