##########
#        #
#  $     #
##### $  #
# @##    #
#   ###  #
# #.$.   #
#       ##
# .      #
##########
