###########
#         #
#         #
#         #
#. #@     #
#  $ #    #
#     #  ##
#       ###
#   #    ##
# #       #
###########
