##########
# #      #
# ##   * #
# #    ###
# ##   # #
##    $###
## . @  ##
##  $   ##
#. $.#   #
##########
