##########
## ##   .#
#   ## # #
# $    $ #
# .  ##  #
#  . ##$ #
#  $    @#
####  .  #
#        #
##########
