###########
##        #
#   # ##  #
#  #     ##
##$    #  #
#  #      #
#     .#  #
#    #    #
##        #
#  ##    @#
###########
