###########
#         #
#.        #
#   #     #
##    $ . #
##  #     #
#     ##  #
#     #   #
# $   #   #
# @       #
###########
