##########
#@ .     #
#  $ . $##
#  ####  #
#     #$ #
#     .  #
###     ##
##   $## #
#  .     #
##########
