###########
#  .   .# #
#      ####
#    ### @#
#    ###  #
#  . # $  #
#  $      #
#   $#    #
#    ## # #
#     ### #
###########
