############
#  ##      #
#     .  # #
#   .  #$  #
#    #   # #
#     #   ##
#      #   #
#@  $      #
###   #    #
##         #
#         ##
############
