###########
#     .   #
# $###    #
#   #     #
# $ #.$#  #
#      #$##
#   #. @ ##
# .###  ###
#   #     #
#     #   #
###########
