############
#       #  #
#       $  #
# $  . # # #
#     . .  #
#       #  #
#         @#
# #     ## #
##   $     #
#  #      ##
#         ##
############
