############
#     #    #
#  .#   .  #
# $   # ## #
#@         #
#   .      #
#          #
#   #      #
#   $$# #  #
#        # #
##   #   # #
############
