###########
#  $    . #
#         #
#      .  #
#  $#  $# #
#   #    ##
#   ##    #
#@###    .#
#   # $   #
#.#   #   #
###########
