###########
# ##   .  #
# ###   . #
#      ## #
#      @  #
##  ###   #
#    $    #
#   #$##  #
#.    # $ #
# #   ##  #
###########
