############
##     #   #
##. #  $  ##
##    $    #
#     #    #
#         ##
#    . # # #
##         #
#          #
# @   #    #
##   ##    #
############
