###########
#  ##     #
# # #    ##
#   ##  # #
#      ####
# .  . .# #
#  $   $  #
# $$#     #
#   # ### #
# @ ###  .#
###########
