############
#   #      #
#          #
#       #  #
###   $  . #
#  $ ##    #
#      #   #
#   .      #
#       # ##
#   #  # # #
# @        #
############
