############
#        . #
#    # #   #
# #        #
#    # @  ##
#       #  #
#    # ##  #
#          #
#  #       #
#.   $   $ #
##         #
############
