###########
#    ##   #
#   #     #
######    #
# #   ##  #
#  $ $ #  #
#      .. #
#.#     @ #
# $       #
# *       #
###########
