###########
#  ..$    #
# $  ###$ #
#   @  #  #
# ## #.   #
#    #    #
#    ### ##
#      $  #
## #   #  #
#### .    #
###########
