############
#  #       #
#    .    @#
#.    ## $ #
# ##       #
#   #    # #
#       ## #
#  $#      #
#         ##
#         ##
#          #
############
