############
# #    #   #
#         ##
#     # .  #
##   .  ## #
#  $# $ *  #
#    # $ . #
##    #    #
#  #   #   #
#  @  #    #
#     # #  #
############
