###########
#   ###   #
# $ ###$  #
#       . #
#$  ##### #
#.    #####
#  .@     #
# $       #
#  # .    #
#  #      #
###########
