###########
#         #
#    #   .#
#      $$ #
# @  ## # #
#.## ## ###
#    #   ##
#  ..##  ##
#     $$ ##
#        ##
###########
