############
# # #  # # #
#   ##   . #
#   ##    ##
#          #
##.   .    #
#        $ #
#          #
# $  @   # #
#       $  #
#      ##  #
############
