###########
#   .   ###
# #$.   ###
##    @## #
##     $  #
###       #
# # $    ##
# ##      #
# $ .     #
#    .  # #
###########
