############
#  ##   #  #
#   #    # #
#   $      #
#.  #  #   #
#          #
#  #  * #  #
##         #
#    #  @  #
#    #     #
##      #  #
############
